Pacman:5
Ghosts:4
MapKolvo:20
MapSize:20
GameSpeed:20
Map
00000000002000000000
02222222221222222220
02000000002200000020
02022222222200222220
02022202200000202020
02022202222222202020
02220002202222222020
02022222202000002020
02020000202222602020
06022222200000202020
22020000222220202022
02022220200022202220
02022030222220202020
02222000220220222020
00202222220220002020
02202020200000302020
02006022222220222020
02202000000020000020
00222222222222222260
00000000002000000000
