Pacman:5
Ghosts:4
MapKolvo:30
MapSize:20
GameSpeed:10
Map
000000000000000000000000000000
022222222222222222222222222210
020000000000000000000000000040
020000000000000000000000000050
020000000000000000000000000040
020000000000000000000000000050
020000000000000000000000000040
020000000000000000000000000050
020000000000000000000000000040
020000000000000000000000000050
020000000000000000000000000040
020000000000000000000000000050
020000000000000000000000000040
020000000000000000000000000050
020000000000000000000000000040
020000000000000000000000000050
020000000000000000000000000040
020000000000000000000000000050
020000000000000000000000000040
020000000000000000000000000050
020000000000000000000000000040
020000000000000000000000000050
020000000000000000000000000040
020000000000000000000000000050
020000000000000000000000000040
020000000000000000000000000005
020000000000000000000000000040
020000000000000000000000000050
062222222222222222222222222220
000000000000000000000000000000