Pacman:5
Ghosts:2
MapKolvo:18
MapSize:20
GameSpeed:20
Map
000000000000000000
012222222222222220
000000000000000020
000000000000000020
000000000000000020
042222222222222220
000000000000000000
000000000000000000
000000000000000000
000000000000000000
000000000000000000
000000000000000000
000000000000000000
000000000000000000
000000000000000000
000000000000000000
000000000000000000
000000000000000000